SO textures/leather/south.xpm
NO textures/leather/north.xpm
WE textures/leather/west.xpm
EA textures/leather/east.xpm

C 53,41,34,
F 45,33,27

111111111111111
111110000011111
111100000001111
1110000E0000111
110000000000011
100000101000011
100001111100001
100000111000001
110000010000011
111000000000111
111100000001111
111110000011111
111111111111111

