SO textures/doggo/Chuchi_South.xpm
NO textures/doggo/Chuchi_North.xpm
WE textures/doggo/Nattanen_West.xpm
EA textures/doggo/Nattanen_East.xpm

F 164,169,20
C 153,204,255


111111111111111111111111111111111
111110001111111111111111100011111
111110000111111111111110000011111
111110000000000000000000000011111
111110000000000000000000000011111
111110001110000000000011100011111
111110001110000000000011100111111
111111000000000000000000001111111
111111100000000000000000001111111
1111111000000000W0000000001111111
111111110000000111000000011111111
111111111000000010000000111111111
111111111100001111100001111111111
111111111110000000000011111111111
111111111111111111111111111111111