SO textures/doggo/Chuchi_South.xpm
NO textures/doggo/Chuchi_North.xpm
WE textures/doggo/Nattanen_West.xpm
EA textures/doggo/Nattanen_East.xpm

F 164,169,20
C 153,204,255


111111111111111111111111111111111
111110001111111111111111100011111
111110000111111111111110000011111
111110000000000000000000000011111
111110000000000000000000000011111
111110001110000000000011100011111
111110001110000000000011100111111
11111100000000000W000000001111111
111111100000000000000000001111111
10000000000000001100000010001
10000000000000001101010010001
110000011101010111110111100111
11110111 1110101 101111010001
11111111 1111111 111111111111