C 76,76,76
F 69,75,27

NO textures/rocks/north.xpm
SO textures/rocks/south.xpm
WE textures/rocks/west.xpm
EA textures/rocks/east.xpm

1111111111111111111
1001001000001000001
1011000001000001001
1001001001111101111
1001111000001001001
10E0000000000001001
1001100111111001001
1111000001000001011
1000000001000000001
1111111111111111111



