NO textures/texx_xpm/Abstract_1.xpm
EA textures/texx_xpm/Abstract_2.xpm
SO textures/texx_xpm/Abstract_3.xpm
WE textures/texx_xpm/Abstract_4.xpm

C 251,237,241
F 151,127,192

111111111111111111111111
100000000000011111110001
101111111111011111000111
100000000000011111001111
101111111111111111001111
100000000000000000000001
100111111111111111111001
100100000000000000000001
100111111111111111111001
100000000000000000000001
100111111111111111111001
100100000000000000000001
100000000000000000000001
111111111110000111111111
100000000000011111111111
101111111111011111111111
100000000000011111111111
101111111111111111111111
100000000000000000000001
100111111111111111111001
100100000000000000000001
100111111111111111111001
100000000000000000000001
100111111111111111111001
100000000000000000000001
111111111111111111111111
