SO textures/doggo/Chuchi_South.xpm
NO textures/doggo/Chuchi_North.xpm
WE textures/doggo/Nattanen_West.xpm
EA textures/doggo/Nattanen_East.xpm

F 164,169,20
C 153,204,255

1111111
1001001
1000001
1000001
1000001
100N001
1111111
