NO textures/test/north.xpm
SO textures/test/south.xpm
WE textures/test/west.xpm
EA textures/test/east.xpm

F 20,       20,    20
C 200,200,200

111111111111111111111
1W0000000000000000001
111111111111111111111
