1111111
1     1
1     1
1     1
1     1
1 11  1
11 11 1
11  N 1
11 0 111
1111111
11  11
11  11