1111111
1     1
1     1
1     1
1     1
1 11  1
11 11 1
11  N 1     111
11 0 11     111
1111111     111
11   11
11   11
1