NO textures/wolfenstein/grey_stone.xpm
SO textures/wolfenstein/purple_stone.xpm
WE textures/wolfenstein/red_brick.xpm
EA textures/wolfenstein/wood.xpm

F 220,100,0
C 225,30,0

1111111111111111111111111
1N00000000110000000000001
1011000001110000000000001
1001000000000000000000001
1011000001110000000000001
1000000000110000011111111
1111011111111101110000001    111
1111011111111101110101001    1 1
1100000011010101110000001    111
1111111111111111111111111
