SO textures/doggo/Chuchi_South.xpm
NO textures/doggo/Chuchi_North.xpm
WE textures/doggo/Nattanen_West.xpm
EA textures/doggo/Nattanen_East.xpm

F 164,169,20
C 153,204,255


11111111111111111111111111111
11111111100000000001111111111
11100011100000000001111000111
11100001111111D11111100000111
11100000000000000000000000111
111000000000C0000000000000111
11100011100000000000111000111
1110001110C000000000111001111
11110000000000W00000000011111
11111000000000000000000011111
11111000000000000000000011111
11111100000001D10000000111111
11111110000000D00000001111111
11111111000011D11000011111111
11111111100010001000111111111
11111111110001110001111111111
11111111111000000011111111111
11111111111111111111111111111