SO textures/doggo/Chuchi_South.xpm
NO textures/doggo/Chuchi_North.xpm
WE textures/doggo/Nattanen_West.xpm
EA textures/doggo/Nattanen_East.xpm

F 164,169,20
C 153,204,255


11111111111111111111111111111
11100011100000000011111000111
1110000111111D111111100000111
11100000000000000000000000111
11100000000000000000000000111
11100011100000000000111000111
11100011100000000000111001111
11110000000000000000000011111
11111000000000000000000011111
11111000000000W00000000011111
11111100000001110000000111111
11111110000000100000001111111
11111111000011111000011111111
11111111100000000000111111111
11111111111111111111111111111