C 76,76,76
F 69,75,27

NO textures/rocks/north.xpm
SO textures/rocks/south.xpm
WE textures/rocks/west.xpm
EA textures/rocks/east.xpm

1111111111111111111
1001001000001000001
1011000001000001001
10010011D1111111111
1001111000001001001
10E000000000000D001
1000000000000001001
1000000000000001001
1000000000000001001
100111D111111001001
1111000001000001011
1000000001000001001
1111111111111111111
