   WE                            textures/winter/west.xpm
NO textures/winter/north.xpm



SO textures/winter/south.xpm

F   240, 248, 255

EA textures/winter/east.xpm



C 200,233,233

111111111111111111111111
100000000000000000000001
100000000000000000000001
100000000000000000000001
100000000000000000000001
100000000000000000000001
100000000000000000000001
111111111111D11111111111
100000100000001000000001
100000100000001000010001
100000100000001000000001
100000111110001010100001
100000000011D11000000001
100000000000000000000001
100000000000000000000001
100000000000000000000001
111111111000000000S00001
100100001000000000000001
100000101000000000000001
10000000D000000000000001
111111111000000000000001
100000000000000000000001
100000000000000000000001
111111111111111111111111
