NO textures/lava/north.xpm
SO textures/lava/south.xpm
WE textures/lava/east.xpm
EA textures/lava/east.xpm

C 30,30,30
F 128,0,0

111111111111111111111
101000001000000000001
100010101011111110001
100010100010000010001
1111101011111D1011101
100000100000101000001
101111100011101111111
101000000010100000101
101011111010111D10101
101010001010100010101
101010101010101010101
100000101010001010001
111111101011111011101
1000001010001000D0001
101110101100101110111
101000100000100010101
10001D111111111010001
101110000000000010001
101000011000111111101
1N1000001000000000001
111111111111111111111