NO textures/texx_xpm/Abstract_1.xpm
EA textures/texx_xpm/Abstract_2.xpm
SO textures/texx_xpm/Abstract_1.xpm
WE textures/texx_xpm/Abstract_2.xpm

C 241,156,187
F 151,127,192

111111111111111111111111
100000000000011111110001
101111111111011111000111
100000000000011111001111
101111111111111111001111
100000000000000000000001
100111111111111111111001
100100000000000000000001
100111111111111111111001
1000000000000000E0000001
100111111111111111111001
100100000000000000000001
100000000000000000000001
1111111111100001111D1111
1000000000000111111D1111
1011111111110111111D1111
1000000000000111111D1111
1011111111111111111D1111
100000000000000000000001
100111111111111111111001
100100000000000000000001
100111111111111111111001
100000000000000000000001
100111111111111111111001
100000000000000000000001
111111111111111111111111
